cnt;adr;fei;rssi;rawcm;rssicor;feicor;res;corres
2419;0x77;182559;113;833;775;-1880;-272;49
2420;0x55;180947;72;8660;219;-1863;7016;5798
2421;0x66;182559;76;10235;198;-1880;8553;7950
2422;0x77;176111;113;957;775;-1813;-81;65
2423;0x55;180947;72;8635;219;-1863;6991;5766
2424;0x66;176111;76;9731;198;-1813;8116;7317
2425;0x77;176111;113;748;775;-1813;-290;50
2426;0x55;180947;71;8572;230;-1863;6939;5701
2427;0x66;182559;76;10125;198;-1880;8443;7791
2428;0x77;182559;113;754;775;-1880;-351;58
2429;0x55;180947;70;8121;223;-1863;6481;5160
2430;0x66;182559;76;9800;198;-1880;8118;7320
2431;0x77;182559;113;901;775;-1880;-204;49
2432;0x55;180947;70;8358;223;-1863;6718;5432
2433;0x66;182559;76;9859;198;-1880;8177;7405
2434;0x77;182559;112;1070;745;-1880;-65;69
2435;0x55;181753;71;8836;230;-1872;7194;6028
2436;0x66;182559;76;9582;198;-1880;7900;7005
2437;0x77;182559;113;685;775;-1880;-420;74
2438;0x55;181753;71;8252;230;-1872;6610;5306
2439;0x66;182559;75;9737;228;-1880;8085;7272
2440;0x77;182559;112;908;745;-1880;-227;48
2441;0x55;181753;70;8685;223;-1872;7036;5823
2442;0x66;176917;75;9512;228;-1822;7918;7031
2443;0x77;176917;113;1045;775;-1822;-2;86
2444;0x55;181753;71;9091;230;-1872;7449;6370
2445;0x66;176917;75;9451;228;-1822;7857;6943
2446;0x77;176917;112;894;745;-1822;-183;50
2447;0x55;181753;71;9104;230;-1872;7462;6388
2448;0x66;182559;75;9969;228;-1880;8317;7609
2449;0x77;182559;112;872;745;-1880;-263;48
2450;0x55;181753;71;9075;230;-1872;7433;6348
2451;0x66;176917;75;9476;228;-1822;7882;6979
2452;0x77;176917;114;1056;789;-1822;23;94
2453;0x55;181753;70;8820;223;-1872;7171;5998
2454;0x66;176917;75;9726;228;-1822;8132;7340
2455;0x77;176917;113;678;775;-1822;-369;61
2456;0x55;181753;71;9120;230;-1872;7478;6410
2457;0x66;181753;75;9893;228;-1872;8249;7510
2458;0x77;181753;112;761;745;-1872;-366;60
2459;0x55;181753;71;8899;230;-1872;7257;6111
2460;0x66;181753;75;9888;228;-1872;8244;7503
2461;0x77;181753;113;960;775;-1872;-137;55
2462;0x55;181753;72;9106;219;-1872;7453;6376
2463;0x66;181753;75;9787;228;-1872;8143;7356
2464;0x77;181753;112;664;745;-1872;-463;88
2465;0x55;180947;71;9005;230;-1863;7372;6265
2466;0x66;182559;76;9967;198;-1880;8285;7562
2467;0x77;182559;113;716;775;-1880;-389;65
2468;0x55;180947;71;8671;230;-1863;7038;5826
2469;0x66;182559;75;9843;228;-1880;8191;7426
2470;0x77;176111;113;1072;775;-1813;34;97
2471;0x55;180947;72;8883;219;-1863;7239;6087
2472;0x66;176111;75;9789;228;-1813;8204;7445
2473;0x77;176111;113;754;775;-1813;-284;50
2474;0x55;181753;72;9219;219;-1872;7566;6532
2475;0x66;176111;76;9746;198;-1813;8131;7339
2476;0x77;181753;111;1038;791;-1872;-43;74
2477;0x55;181753;72;8969;219;-1872;7316;6190
2478;0x66;181753;76;10019;198;-1872;8345;7649
2479;0x77;181753;113;748;775;-1872;-349;57
2480;0x55;181753;71;8849;230;-1872;7207;6045
2481;0x66;176917;76;9744;198;-1822;8120;7323
2482;0x77;176917;113;1047;775;-1822;0;86
2483;0x55;180947;71;9271;230;-1863;7638;6632
2484;0x66;176917;76;9868;198;-1822;8244;7503
2485;0x77;181753;112;768;745;-1872;-359;59
2486;0x55;180947;71;8707;230;-1863;7074;5872
2487;0x66;181753;75;10125;228;-1872;8481;7846
2488;0x77;181753;112;703;745;-1872;-424;75
2489;0x55;180947;71;8464;230;-1863;6831;5568
2490;0x66;181753;75;9942;228;-1872;8298;7581
2491;0x77;181753;112;964;745;-1872;-163;52
2492;0x55;180947;71;9350;230;-1863;7717;6744
2493;0x66;181753;75;9816;228;-1872;8172;7398
2494;0x77;181753;111;669;791;-1872;-412;71
2495;0x55;180947;71;9850;230;-1863;8217;7464
2496;0x66;182559;74;9505;207;-1880;7832;6907
2497;0x77;182559;110;863;809;-1880;-208;49
2498;0x55;180947;70;9676;223;-1863;8036;7201
2499;0x66;176917;74;9616;207;-1822;8001;7150
2500;0x77;176917;109;1032;743;-1822;-47;73
2501;0x55;180947;70;9658;223;-1863;8018;7175
2502;0x66;176917;72;9746;219;-1822;8143;7356
2503;0x77;176917;107;872;754;-1822;-196;49
2504;0x55;180947;69;7150;221;-1863;5508;4218
2505;0x66;182559;70;10968;223;-1880;9311;8975
2506;0x77;182559;105;883;728;-1880;-269;49
2507;0x55;180947;70;6999;223;-1863;5359;4097
2508;0x66;182559;67;13526;223;-1880;11869;11869
2509;0x77;176917;103;1014;763;-1822;-45;74
2510;0x55;180947;68;7358;226;-1863;5721;4401
2511;0x66;176917;68;9679;226;-1822;8083;7269
2512;0x77;176917;101;763;791;-1822;-268;49
2513;0x55;180947;67;6476;223;-1863;4836;3712
2514;0x66;181753;74;11071;207;-1872;9406;9090
2515;0x77;181753;101;899;791;-1872;-182;50
2516;0x55;180947;72;9383;219;-1863;7739;6775
2517;0x66;181753;67;7934;223;-1872;6285;4948
2518;0x77;181753;99;1056;743;-1872;-73;67
2519;0x55;180947;73;8065;205;-1863;6407;5079
2520;0x66;181753;66;9616;223;-1872;7967;7101
2521;0x77;181753;80;1469;280;-1872;-123;57
2522;0x55;180947;73;10368;205;-1863;8710;8173
2523;0x66;181753;65;11265;216;-1872;9609;9321
2524;0x77;182559;91;1264;482;-1880;-134;56
2525;0x55;180947;73;9408;205;-1863;7750;6790
2526;0x66;182559;68;11087;226;-1880;9433;9122
2527;0x77;182559;81;1336;310;-1880;-234;48
2528;0x55;180947;71;7892;230;-1863;6259;4920
2529;0x66;176111;68;8520;226;-1813;6933;5694
2530;0x77;176111;89;1460;461;-1813;108;126
2531;0x55;180947;72;7644;219;-1863;6000;4660
2532;0x66;176111;70;7761;223;-1813;6171;4830
2533;0x77;176111;83;1471;388;-1813;46;101
2534;0x55;180947;74;8716;207;-1863;7060;5854
2535;0x66;182559;71;11585;230;-1880;9935;9640
2536;0x77;182559;81;1496;310;-1880;-74;67
2537;0x55;180947;72;7795;219;-1863;6151;4809
2538;0x66;176111;68;9113;226;-1813;7526;6476
2539;0x77;176111;81;1532;310;-1813;29;96
2540;0x55;180947;73;8043;205;-1863;6385;5055
2541;0x66;176111;71;10069;230;-1813;8486;7853
2542;0x77;176111;81;1478;310;-1813;-25;79
2543;0x55;180947;74;10260;207;-1863;8604;8023
2544;0x66;182559;71;9884;230;-1880;8234;7488
2545;0x77;182559;77;1557;209;-1880;-114;59
2546;0x55;180947;74;7804;207;-1863;6148;4806
2547;0x66;182559;73;8207;205;-1880;6532;5217
2548;0x77;182559;81;1703;310;-1880;133;136
2549;0x55;180947;74;8653;207;-1863;6997;5774
2550;0x66;182559;73;10310;205;-1880;8635;8067
2551;0x77;182559;78;1992;219;-1880;331;242
2552;0x55;181753;74;9825;207;-1872;8160;7381
2553;0x66;182559;74;9350;207;-1880;7677;6687
2554;0x77;182559;84;1347;468;-1880;-65;69
2555;0x55;181753;74;8250;207;-1872;6585;5278
2556;0x66;182559;70;8764;223;-1880;7107;5914
2557;0x77;176111;78;2109;219;-1813;515;367
2558;0x55;181753;74;8692;207;-1872;7027;5812
2559;0x66;176111;71;9118;230;-1813;7535;6489
2560;0x77;176111;75;1586;228;-1813;1;87
2561;0x55;180947;75;9938;228;-1863;8303;7588
2562;0x66;176111;75;9645;228;-1813;8060;7236
2563;0x77;183365;76;1577;198;-1888;-113;59
2564;0x55;180947;72;8523;219;-1863;6879;5627
2565;0x66;183365;76;9749;198;-1888;8059;7234
2566;0x77;183365;77;1748;209;-1888;69;110
2567;0x55;180947;72;8931;219;-1863;7287;6151
2568;0x66;176111;72;8780;219;-1813;7186;6017
2569;0x77;176111;76;2021;198;-1813;406;290
2570;0x55;180947;74;9449;207;-1863;7793;6852
2571;0x66;176111;73;9875;205;-1813;8267;7536
2572;0x77;182559;76;1059;198;-1880;-623;171
2573;0x55;180947;73;8347;205;-1863;6689;5398
2574;0x66;182559;68;8687;226;-1880;7033;5820
2575;0x77;182559;74;1568;207;-1880;-105;60
2576;0x55;180947;76;9255;198;-1863;7590;6565
2577;0x66;182559;72;10093;219;-1880;8432;7775
2578;0x77;182559;71;1169;230;-1880;-481;95
2579;0x55;180947;74;9136;207;-1863;7480;6413
2580;0x66;182559;73;9600;205;-1880;7925;7041
2581;0x77;182559;76;2478;198;-1880;796;592
2582;0x55;180947;74;8304;207;-1863;6648;5350
2583;0x66;182559;73;8793;205;-1880;7118;5929
2584;0x77;182559;73;1210;205;-1880;-465;88
2585;0x55;180947;74;9609;207;-1863;7953;7081
2586;0x66;176111;69;4561;221;-1813;2969;2493
2587;0x77;176111;73;2163;205;-1813;555;396
2588;0x55;180947;73;8031;205;-1863;6373;5042
2589;0x66;176111;74;8570;207;-1813;6964;5732
2590;0x77;176111;78;2053;219;-1813;459;326
2591;0x55;181753;73;9129;205;-1872;7462;6388
2592;0x66;182559;72;8345;219;-1880;6684;5392
2593;0x77;182559;79;1974;230;-1880;324;238
2594;0x55;181753;75;9077;228;-1872;7433;6348
2595;0x66;182559;72;8004;219;-1880;6343;5009
2596;0x77;176111;71;2970;230;-1813;1387;1136
2597;0x55;181753;70;7869;223;-1872;6220;4880
2598;0x66;176111;69;10452;221;-1813;8860;8383
2599;0x77;176111;66;3283;223;-1813;1693;1426
2600;0x55;181753;74;9467;207;-1872;7802;6864
2601;0x66;182559;75;9147;228;-1880;7495;6433
2602;0x77;182559;71;2429;230;-1880;779;577
2603;0x55;181753;73;8595;205;-1872;6928;5688
2604;0x66;182559;73;9568;205;-1880;7893;6995
2605;0x77;182559;61;5784;230;-1880;4134;3256
2606;0x55;181753;70;7772;223;-1872;6123;4781
2607;0x66;182559;76;9884;198;-1880;8202;7442
2608;0x77;182559;66;4101;223;-1880;2444;2090
2609;0x55;180947;74;8712;207;-1863;7056;5849
2610;0x66;182559;74;9931;207;-1880;8258;7523
2611;0x77;181753;74;2294;207;-1872;629;454
2612;0x55;180947;73;8439;205;-1863;6781;5508
2613;0x66;181753;74;9102;207;-1872;7437;6354
2614;0x77;181753;71;2201;230;-1872;559;399
2615;0x66;176111;72;8124;219;-1813;6530;5215
2616;0x77;176111;76;2314;198;-1813;699;510
2617;0x55;180947;72;9487;219;-1863;7843;6923
2618;0x66;176111;74;10449;207;-1813;8843;8359
2619;0x77;176111;74;2075;207;-1813;469;333
2620;0x55;180947;72;9230;219;-1863;7586;6559
2621;0x66;181753;71;9877;230;-1872;8235;7490
2622;0x77;181753;76;2481;198;-1872;807;601
2623;0x55;180947;73;8611;205;-1863;6953;5719
2624;0x66;176111;74;10087;207;-1813;8481;7846
2625;0x77;176111;75;2902;228;-1813;1317;1070
2626;0x55;180947;75;9548;228;-1863;7913;7023
2627;0x66;176111;72;9571;219;-1813;7977;7116
2628;0x77;176111;79;2382;230;-1813;799;594
2629;0x55;181753;70;7430;223;-1872;5781;4455
2630;0x66;181753;73;8541;205;-1872;6874;5621
2631;0x77;181753;75;2647;228;-1872;1003;776
2632;0x55;181753;73;9356;205;-1872;7689;6704
2633;0x66;181753;72;8453;219;-1872;6800;5531
2634;0x77;181753;77;2548;209;-1872;885;669
2635;0x55;181753;73;8248;205;-1872;6581;5273
2636;0x66;181753;71;6213;230;-1872;4571;3534
2637;0x77;181753;69;2400;221;-1872;749;552
2638;0x55;181753;73;9564;205;-1872;7897;7000
2639;0x66;181753;73;8194;205;-1872;6527;5212
2640;0x77;181753;66;2776;223;-1872;1127;890
2641;0x55;181753;72;7916;219;-1872;6263;4925
2642;0x66;181753;73;8849;205;-1872;7182;6012
2643;0x77;176917;66;3578;223;-1822;1979;1689
2644;0x55;181753;73;7662;205;-1872;5995;4655
2645;0x66;176917;72;10053;219;-1822;8450;7801
2646;0x77;176917;73;2963;205;-1822;1346;1097
2647;0x55;180141;69;8419;221;-1855;6785;5512
2648;0x66;176917;69;8764;221;-1822;7163;5987
2649;0x77;182559;70;2131;223;-1880;474;337
2650;0x55;180141;72;7989;219;-1855;6353;5020
2651;0x66;182559;72;9640;219;-1880;7979;7118
2652;0x77;182559;73;2296;205;-1880;621;447
2653;0x55;180141;72;8915;219;-1855;7279;6140
2654;0x66;176111;74;9861;207;-1813;8255;7519
2655;0x77;176111;66;3389;223;-1813;1799;1525
2656;0x55;180141;72;8489;219;-1855;6853;5595
2657;0x66;176111;76;10132;198;-1813;8517;7898
2658;0x77;181753;61;3060;230;-1872;1418;1166
2659;0x55;180141;72;8288;219;-1855;6652;5355
2660;0x66;181753;75;9151;228;-1872;7507;6450
2661;0x77;181753;71;2055;230;-1872;413;295
2662;0x55;180141;74;8469;207;-1855;6821;5556
2663;0x66;181753;72;10089;219;-1872;8436;7781
2664;0x77;181753;67;2713;223;-1872;1064;832
2665;0x55;180141;75;9951;228;-1855;8324;7619
2666;0x66;181753;70;7930;223;-1872;6281;4944
2667;0x77;181753;74;3125;207;-1872;1460;1206
2668;0x55;180141;73;8185;205;-1855;6535;5221
2669;0x66;182559;71;9746;230;-1880;8096;7288
2670;0x77;182559;63;4901;215;-1880;3236;2680
2671;0x55;180141;73;8464;205;-1855;6814;5548
2672;0x66;176111;72;5025;219;-1813;3431;2811
2673;0x77;176111;67;3146;223;-1813;1556;1297
2674;0x55;180141;74;9564;207;-1855;7916;7028
2675;0x66;176111;75;7157;228;-1813;5572;4272
2676;0x77;176111;66;3073;223;-1813;1483;1227
2677;0x55;180947;72;8958;219;-1863;7314;6187
2678;0x66;181753;75;8964;228;-1872;7320;6195
2679;0x77;181753;68;1444;226;-1872;-202;49
2680;0x55;180947;72;6726;219;-1863;5082;3886
2681;0x66;181753;74;8167;207;-1872;6502;5184
2682;0x77;176111;70;3731;223;-1813;2141;1833
2683;0x55;180947;71;7094;230;-1863;5461;4180
2684;0x66;176111;74;9372;207;-1813;7766;6813
2685;0x77;176111;72;3085;219;-1813;1491;1235
2686;0x55;180947;73;9185;205;-1863;7527;6477
2687;0x66;181753;72;7822;219;-1872;6169;4828
2688;0x77;181753;73;3143;205;-1872;1476;1221
2689;0x55;180947;72;8793;219;-1863;7149;5969
2690;0x66;181753;68;4795;226;-1872;3149;2621
2691;0x55;180947;74;9758;207;-1863;8102;7297
2692;0x66;181753;75;7756;228;-1872;6112;4770
2693;0x77;181753;71;3664;230;-1872;2022;1728
2694;0x55;180947;72;8622;219;-1863;6978;5750
2695;0x66;181753;75;8187;228;-1872;6543;5230
2696;0x77;181753;75;2789;228;-1872;1145;907
2697;0x55;180947;73;9690;205;-1863;8032;7195
2698;0x66;181753;75;7635;228;-1872;5991;4651
2699;0x77;181753;75;2841;228;-1872;1197;956
2700;0x55;180947;75;9629;228;-1863;7994;7140
2701;0x66;176111;74;8230;207;-1813;6624;5322
2702;0x77;176111;79;3096;230;-1813;1513;1256
2703;0x55;181753;71;8804;230;-1872;7162;5986
2704;0x66;176111;73;7186;205;-1813;5578;4277
2705;0x77;176111;76;2305;198;-1813;690;503
2706;0x55;181753;74;9753;207;-1872;8088;7276
2707;0x66;181753;73;9246;205;-1872;7579;6550
2708;0x77;181753;76;2713;198;-1872;1039;809
2709;0x55;181753;73;7838;205;-1872;6171;4830
2710;0x66;176111;71;8917;230;-1813;7334;6214
2711;0x77;176111;76;3626;198;-1813;2011;1718
2712;0x55;181753;73;7948;205;-1872;6281;4944
2713;0x66;176111;73;8101;205;-1813;6493;5174
2714;0x77;176111;75;2961;228;-1813;1376;1126
2715;0x55;179335;73;9045;205;-1847;7403;6307
2716;0x66;182559;74;9476;207;-1880;7803;6866
2717;0x77;182559;76;3100;198;-1880;1418;1166
2718;0x55;179335;74;8216;207;-1847;6576;5267
2719;0x66;182559;70;9158;223;-1880;7501;6442
2720;0x77;182559;75;3121;228;-1880;1469;1214
2721;0x55;179335;74;8529;207;-1847;6889;5639
2722;0x66;182559;67;7840;223;-1880;6183;4842
2723;0x77;182559;75;2544;228;-1880;892;676
2724;0x55;181753;74;9406;207;-1872;7741;6778
2725;0x66;181753;73;7844;205;-1872;6177;4836
2726;0x77;181753;74;2487;207;-1872;822;614
2727;0x55;181753;74;8701;207;-1872;7036;5823
2728;0x66;181753;74;7346;207;-1872;5681;4366
2729;0x77;176111;76;3713;198;-1813;2098;1795
2730;0x55;181753;76;9383;198;-1872;7709;6732
2731;0x66;176111;74;7231;207;-1813;5625;4317
2732;0x77;176111;76;3468;198;-1813;1853;1574
2733;0x55;180947;74;9289;207;-1863;7633;6625
2734;0x66;176111;74;8214;207;-1813;6608;5304
2735;0x77;181753;74;3709;207;-1872;2044;1747
2736;0x55;180947;74;9758;207;-1863;8102;7297
2737;0x66;181753;70;6981;223;-1872;5332;4076
2738;0x77;181753;75;2853;228;-1872;1209;967
2739;0x55;180947;73;9456;205;-1863;7798;6859
2740;0x66;175305;72;7777;219;-1805;6191;4850
2741;0x77;175305;75;3522;228;-1805;1945;1658
2742;0x55;180947;73;9347;205;-1863;7689;6704
2743;0x66;175305;77;8662;209;-1805;7066;5862
2744;0x77;182559;72;3729;219;-1880;2068;1769
2745;0x55;180947;73;8771;205;-1863;7113;5922
2746;0x66;182559;77;8829;209;-1880;7158;5981
2747;0x77;182559;70;2607;223;-1880;950;728
2748;0x55;180947;73;8624;205;-1863;6966;5735
2749;0x66;182559;75;7876;228;-1880;6224;4884
2750;0x77;182559;70;3407;223;-1880;1750;1479
2751;0x55;180947;73;8239;205;-1863;6581;5273
2752;0x66;182559;76;8018;198;-1880;6336;5002
2753;0x77;182559;68;3393;226;-1880;1739;1469
2754;0x55;180947;75;8446;228;-1863;6811;5544
2755;0x66;182559;78;7824;219;-1880;6163;4821
2756;0x77;182559;71;4358;230;-1880;2708;2299
2757;0x55;180947;75;9566;228;-1863;7931;7049
2758;0x77;176111;71;3481;230;-1813;1898;1616
2759;0x55;180947;70;6941;223;-1863;5301;4052
2760;0x66;176111;76;6889;198;-1813;5274;4031
2761;0x77;176111;70;2983;223;-1813;1393;1142
2762;0x55;180947;74;10274;207;-1863;8618;8043
2763;0x66;181753;76;7065;198;-1872;5391;4123
2764;0x77;181753;71;4042;230;-1872;2400;2053
2765;0x55;180947;75;9800;228;-1863;8165;7388
2766;0x66;181753;77;7394;209;-1872;5731;4410
2767;0x77;176111;68;4942;226;-1813;3355;2760
2768;0x55;180947;74;8331;207;-1863;6675;5382
2769;0x66;176111;74;6772;207;-1813;5166;3949
2770;0x77;176111;67;4211;223;-1813;2621;2232
2771;0x55;180947;73;8520;205;-1863;6862;5606
2772;0x66;181753;76;7632;198;-1872;5958;4619
2773;0x77;181753;66;3587;223;-1872;1938;1652
2774;0x55;180947;74;9379;207;-1863;7723;6752
2775;0x66;181753;72;5805;219;-1872;4152;3267
2776;0x77;181753;67;3919;223;-1872;2270;1944
2777;0x55;180947;74;8631;207;-1863;6975;5746
2778;0x66;181753;68;8270;226;-1872;6624;5322
2779;0x77;181753;63;2963;215;-1872;1306;1059
2780;0x55;180947;74;8870;207;-1863;7214;6054
2781;0x66;181753;76;6711;198;-1872;5037;3853
2782;0x77;181753;58;5009;216;-1872;3353;2759
2783;0x55;180947;75;10357;228;-1863;8722;8190
2784;0x66;181753;77;8315;209;-1872;6652;5355
2785;0x77;181753;59;4349;223;-1872;2700;2293
2786;0x55;180947;76;8516;198;-1863;6851;5593
2787;0x66;177723;70;6375;223;-1830;4768;3665
2788;0x77;177723;59;2688;223;-1830;1081;848
2789;0x55;180947;77;10646;209;-1863;8992;8563
2790;0x66;177723;76;7022;198;-1830;5390;4122
2791;0x77;177723;68;3666;226;-1830;2062;1763
2792;0x55;180947;72;8861;219;-1863;7217;6058
2793;0x66;182559;74;7078;207;-1880;5405;4134
2794;0x77;182559;69;3416;221;-1880;1757;1486
2795;0x55;180947;74;10093;207;-1863;8437;7783
2796;0x66;176917;74;7540;207;-1822;5925;4588
2797;0x77;176917;71;3835;230;-1822;2243;1921
2798;0x55;180947;75;9124;228;-1863;7489;6425
2799;0x66;176917;73;7989;205;-1822;6372;5041
2800;0x77;176917;72;2877;219;-1822;1274;1029
2801;0x55;181753;73;8786;205;-1872;7119;5930
2802;0x66;182559;72;8031;219;-1880;6370;5038
2803;0x77;182559;68;3504;226;-1880;1850;1572
2804;0x55;181753;72;7736;219;-1872;6083;4741
2805;0x66;182559;74;8581;207;-1880;6908;5663
2806;0x77;182559;71;4160;230;-1880;2510;2143
2807;0x55;181753;75;9298;228;-1872;7654;6655
2808;0x66;182559;73;6488;205;-1880;4813;3696
2809;0x77;182559;68;4520;226;-1880;2866;2418
2810;0x55;181753;75;9888;228;-1872;8244;7503
2811;0x66;181753;71;8620;230;-1872;6978;5750
2812;0x77;181753;69;4108;221;-1872;2457;2100
2813;0x55;181753;73;8710;205;-1872;7043;5832
2814;0x66;181753;75;7993;228;-1872;6349;5016
2815;0x77;176111;67;4205;223;-1813;2615;2227
2816;0x55;181753;74;9043;207;-1872;7378;6273
2817;0x66;176111;75;8502;228;-1813;6917;5674
2818;0x77;176111;69;3761;221;-1813;2169;1857
2819;0x55;180947;73;8660;205;-1863;7002;5780
2820;0x66;176111;73;7508;205;-1813;5900;4564
2821;0x77;182559;56;5852;232;-1880;4204;3300
2822;0x55;180947;75;9541;228;-1863;7906;7013
2823;0x66;182559;75;8153;228;-1880;6501;5182
2824;0x77;182559;68;3704;226;-1880;2050;1753
2825;0x55;180947;73;8858;205;-1863;7200;6036
2826;0x66;177723;76;7279;198;-1830;5647;4336
2827;0x77;177723;66;4371;223;-1830;2764;2342
2828;0x55;180947;74;9341;207;-1863;7685;6698
2829;0x66;177723;74;6530;207;-1830;4907;3761
2830;0x77;181753;69;4432;221;-1872;2781;2355
2831;0x55;180947;75;10510;228;-1863;8875;8403
2832;0x66;181753;75;7745;228;-1872;6101;4759
2833;0x77;181753;68;4430;226;-1872;2784;2357
2834;0x55;180947;73;8106;205;-1863;6448;5124
2835;0x66;181753;77;7520;209;-1872;5857;4524
2836;0x77;181753;68;4619;226;-1872;2973;2496
2837;0x55;181753;75;9834;228;-1872;8190;7424
2838;0x66;181753;75;9307;228;-1872;7663;6667
2839;0x77;181753;61;6310;230;-1872;4668;3598
2840;0x55;181753;75;10109;228;-1872;8465;7823
2841;0x66;181753;70;7533;223;-1872;5884;4549
2842;0x77;181753;62;4964;205;-1872;3297;2722
2843;0x55;181753;73;8487;205;-1872;6820;5555
2844;0x66;176111;75;6136;228;-1813;4551;3521
2845;0x77;176111;66;2931;223;-1813;1341;1092
2846;0x55;181753;75;8705;228;-1872;7061;5855
2847;0x66;176111;71;5135;230;-1813;3552;2889
2848;0x77;176111;55;4146;237;-1813;2570;2191
2849;0x55;180947;75;9406;228;-1863;7771;6820
2850;0x66;181753;73;5379;205;-1872;3712;2991
2851;0x77;181753;60;4912;214;-1872;3254;2692
2852;0x55;180947;74;9192;207;-1863;7536;6490
2853;0x66;181753;75;5652;228;-1872;4008;3177
2854;0x77;177723;60;4347;214;-1830;2731;2317
2855;0x55;180947;75;9278;228;-1863;7643;6639
2856;0x66;177723;69;4108;221;-1830;2499;2134
2857;0x77;177723;66;5757;223;-1830;4150;3266
2858;0x55;180947;77;9548;209;-1863;7894;6996
2859;0x66;181753;69;4180;221;-1872;2529;2159
2860;0x77;181753;57;2704;223;-1872;1055;823
2861;0x55;180947;77;9924;209;-1863;8270;7541
2862;0x66;181753;69;6032;221;-1872;4381;3411
2863;0x55;180947;76;8505;198;-1863;6840;5579
2864;0x66;181753;74;6576;207;-1872;4911;3764
2865;0x77;181753;67;3923;223;-1872;2274;1948
2866;0x55;180141;75;9201;228;-1855;7574;6543
2867;0x66;181753;77;6600;209;-1872;4937;3782
2868;0x77;181753;69;4599;221;-1872;2948;2478
2869;0x55;180141;76;9352;198;-1855;7695;6712
2870;0x66;181753;78;7337;219;-1872;5684;4368
2871;0x77;181753;68;4842;226;-1872;3196;2653
2872;0x55;180141;75;10102;228;-1855;8475;7837
2873;0x66;176917;73;6129;205;-1822;4512;3496
2874;0x77;176917;64;3817;221;-1822;2216;1898
2875;0x55;180141;76;10073;198;-1855;8416;7752
2876;0x66;176917;72;8752;219;-1822;7149;5969
2877;0x77;176917;51;24048;254;-1822;22480;22480
2878;0x55;180141;74;8112;207;-1855;6464;5141
2879;0x66;182559;65;6298;216;-1880;4634;3575
2880;0x77;182559;61;2882;230;-1880;1232;989
2881;0x55;180141;75;10639;228;-1855;9012;8590
2882;0x66;176111;71;4245;230;-1813;2662;2264
2883;0x77;176111;62;4538;205;-1813;2930;2465
2884;0x55;180141;75;8432;228;-1855;6805;5537
2885;0x66;176111;75;6294;228;-1813;4709;3625
2886;0x77;176111;59;9115;223;-1813;7525;6475
2887;0x55;181753;75;9672;228;-1872;8028;7189
2888;0x66;180947;75;6884;228;-1863;5249;4012
2889;0x77;180947;55;8385;237;-1863;6759;5481
2890;0x55;181753;74;9054;207;-1872;7389;6288
2891;0x66;180947;75;6643;228;-1863;5008;3833
2892;0x77;180947;60;5181;214;-1863;3532;2876
2893;0x55;181753;76;9992;198;-1872;8318;7610
2894;0x66;180947;69;6970;221;-1863;5328;4073
2895;0x77;180947;57;1956;223;-1863;316;233
2896;0x55;180141;74;8786;207;-1855;7138;5955
2897;0x66;180947;68;3770;226;-1863;2133;1826
2898;0x77;180947;61;3934;230;-1863;2301;1971
2899;0x55;180141;77;9762;209;-1855;8116;7317
2900;0x66;180947;74;6050;207;-1863;4394;3420
2901;0x77;176111;68;4716;226;-1813;3129;2607
2902;0x55;180141;76;8888;198;-1855;7231;6077
2903;0x66;176111;75;6909;228;-1813;5324;4070
2904;0x77;176111;67;2623;223;-1813;1033;803
2905;0x55;180947;76;9731;198;-1863;8066;7244
2906;0x66;176111;75;6805;228;-1813;5220;3989
2907;0x77;182559;68;4951;226;-1880;3297;2722
2908;0x55;180947;76;9257;198;-1863;7592;6568
2909;0x66;182559;78;6298;219;-1880;4637;3577
2910;0x77;182559;72;5124;219;-1880;3463;2831
2911;0x55;180947;77;9891;209;-1863;8237;7493
2912;0x66;177723;76;6208;198;-1830;4576;3537
2913;0x77;177723;65;5789;216;-1830;4175;3281
2914;0x55;180141;75;9016;228;-1855;7389;6288
2915;0x66;177723;74;5843;207;-1830;4220;3310
2916;0x77;181753;67;3946;223;-1872;2297;1967
2917;0x55;180141;76;9381;198;-1855;7724;6753
2918;0x66;181753;75;6312;228;-1872;4668;3598
2919;0x77;181753;70;4430;223;-1872;2781;2355
2920;0x55;180141;78;10244;219;-1855;8608;8028
2921;0x66;181753;75;6068;228;-1872;4424;3439
2922;0x77;181753;69;4164;221;-1872;2513;2146
2923;0x55;180947;76;10630;198;-1863;8965;8526
2924;0x66;181753;71;5345;230;-1872;3703;2986
2925;0x77;181753;70;4973;223;-1872;3324;2740
2926;0x55;180947;71;7096;230;-1863;5463;4181
2927;0x66;182559;74;5546;207;-1880;3873;3093
2928;0x77;182559;74;4376;207;-1880;2703;2295
2929;0x55;180947;75;8520;228;-1863;6885;5634
2930;0x66;176917;76;7161;198;-1822;5537;4242
2931;0x77;176917;73;4712;205;-1822;3095;2583
2932;0x55;180947;75;9841;228;-1863;8206;7448
2933;0x66;176917;74;6190;207;-1822;4575;3537
2934;0x77;176917;69;4473;221;-1822;2872;2423
2935;0x55;181753;74;10463;207;-1872;8798;8297
2936;0x66;180947;72;6039;219;-1863;4395;3420
2937;0x77;180947;76;5025;198;-1863;3360;2764
2938;0x55;181753;75;10048;228;-1872;8404;7735
2939;0x66;180947;75;5906;228;-1863;4271;3342
2940;0x77;176111;76;4779;198;-1813;3164;2631
2941;0x55;181753;77;10258;209;-1872;8595;8010
2942;0x66;176111;78;6091;219;-1813;4497;3486
2943;0x77;176111;76;4626;198;-1813;3011;2523
2944;0x55;181753;74;8809;207;-1872;7144;5962
2945;0x66;181753;78;5174;219;-1872;3521;2869
2946;0x77;181753;77;4815;209;-1872;3152;2623
2947;0x55;181753;74;9316;207;-1872;7651;6650
2948;0x66;181753;75;3689;228;-1872;2045;1748
2949;0x77;181753;76;4752;198;-1872;3078;2571
2950;0x55;181753;75;9282;228;-1872;7638;6632
2951;0x66;181753;75;4912;228;-1872;3268;2702
2952;0x77;181753;75;5072;228;-1872;3428;2809
2953;0x55;180947;76;10600;198;-1863;8935;8486
2954;0x66;181753;72;5870;219;-1872;4217;3308
2955;0x77;182559;77;5282;209;-1880;3611;2927
2956;0x55;180947;76;8933;198;-1863;7268;6126
2957;0x66;182559;74;7306;207;-1880;5633;4324
2958;0x77;182559;77;4667;209;-1880;2996;2513
2959;0x55;180947;75;9465;228;-1863;7830;6904
2960;0x66;176111;78;5455;219;-1813;3861;3085
2961;0x77;176111;77;5205;209;-1813;3601;2921
2962;0x55;181753;74;9755;207;-1872;8090;7279
2963;0x66;176111;76;5153;198;-1813;3538;2880
2964;0x77;176111;78;5140;219;-1813;3546;2885
2965;0x55;181753;74;7691;207;-1872;6026;4685
2966;0x66;181753;75;6003;228;-1872;4359;3397
2967;0x77;181753;79;4849;230;-1872;3207;2660
2968;0x55;181753;76;9557;198;-1872;7883;6980
2969;0x66;177723;74;5561;207;-1830;3938;3133
2970;0x77;177723;77;4831;209;-1830;3210;2663
2971;0x55;181753;75;9607;228;-1872;7963;7095
2972;0x66;177723;76;5794;198;-1830;4162;3273
2973;0x77;177723;78;5149;219;-1830;3538;2880
2974;0x55;181753;76;9773;198;-1872;8099;7292
2975;0x66;182559;74;6661;207;-1880;4988;3818
2976;0x77;182559;77;4723;209;-1880;3052;2553
2977;0x55;181753;77;9305;209;-1872;7642;6638
2978;0x66;182559;76;6402;198;-1880;4720;3633
2979;0x77;182559;77;5124;209;-1880;3453;2825
2980;0x55;181753;75;9604;228;-1872;7960;7091
2981;0x66;182559;78;5280;219;-1880;3619;2932
2982;0x77;182559;77;4421;209;-1880;2750;2331
2983;0x55;180947;75;9733;228;-1863;8098;7291
2984;0x66;182559;77;4714;209;-1880;3043;2546
2985;0x77;182559;79;5135;230;-1880;3485;2846
2986;0x55;180947;75;9591;228;-1863;7956;7085
2987;0x66;182559;76;6001;198;-1880;4319;3372
2988;0x77;176111;77;5374;209;-1813;3770;3028
2989;0x55;180947;75;9611;228;-1863;7976;7114
2990;0x66;176111;75;6102;228;-1813;4517;3499
2991;0x77;176111;76;5120;198;-1813;3505;2859
2992;0x55;180947;75;9945;228;-1863;8310;7599
2993;0x66;176111;77;5485;209;-1813;3881;3098
2994;0x77;181753;76;5147;198;-1872;3473;2838
2995;0x55;180947;73;7810;205;-1863;6152;4810
2996;0x66;181753;76;5546;198;-1872;3872;3092
2997;0x77;181753;78;5196;219;-1872;3543;2883
2998;0x55;180947;74;9444;207;-1863;7788;6844
2999;0x66;177723;79;4971;230;-1830;3371;2771
3000;0x77;177723;79;5683;230;-1830;4083;3224
3001;0x55;180947;76;10292;198;-1863;8627;8055
3002;0x66;177723;77;5764;209;-1830;4143;3261
3003;0x77;181753;78;5039;219;-1872;3386;2781
3004;0x55;180947;76;9228;198;-1863;7563;6527
3005;0x66;181753;77;5199;209;-1872;3536;2879
3006;0x77;181753;79;5293;230;-1872;3651;2953
3007;0x55;180947;77;9740;209;-1863;8086;7273
3008;0x66;181753;77;5821;209;-1872;4158;3271
3009;0x77;181753;78;5489;219;-1872;3836;3070
3010;0x55;180947;75;9764;228;-1863;8129;7336
3011;0x66;181753;78;4408;219;-1872;2755;2335
3012;0x77;181753;78;5323;219;-1872;3670;2965
3013;0x55;180947;76;9284;198;-1863;7619;6606
3014;0x66;181753;75;3432;228;-1872;1788;1514
3015;0x77;181753;77;5789;209;-1872;4126;3251
3016;0x55;180947;75;9469;228;-1863;7834;6910
3017;0x66;176111;70;4432;223;-1813;2842;2400
3018;0x77;176111;76;5780;198;-1813;4165;3275
3019;0x55;180947;74;9510;207;-1863;7854;6939
3020;0x66;176111;76;5897;198;-1813;4282;3349
3021;0x77;176111;76;5370;198;-1813;3755;3019
3022;0x55;180947;76;9868;198;-1863;8203;7443
3023;0x66;176111;75;5210;228;-1813;3625;2936
3024;0x77;176111;77;5336;209;-1813;3732;3004
3025;0x66;176111;78;5600;219;-1813;4006;3176
3026;0x77;176111;77;5446;209;-1813;3842;3073
3027;0x55;180947;77;9411;209;-1863;7757;6800
3028;0x66;176111;79;3907;230;-1813;2324;1990
3029;0x77;176111;77;5739;209;-1813;4135;3256
3030;0x55;180947;75;8872;228;-1863;7237;6084
3031;0x66;183365;78;5277;219;-1888;3608;2925
3032;0x77;183365;76;5356;198;-1888;3666;2962
3033;0x55;180947;76;9402;198;-1863;7737;6772
3034;0x66;183365;78;5496;219;-1888;3827;3064
3035;0x77;183365;77;5604;209;-1888;3925;3125
3036;0x55;180947;77;9568;209;-1863;7914;7025
3037;0x66;183365;81;5214;310;-1888;3636;2943
3038;0x77;183365;76;5442;198;-1888;3752;3017
3039;0x55;180947;75;10046;228;-1863;8411;7745
3040;0x66;183365;79;4036;230;-1888;2378;2035
3041;0x77;181753;76;5769;198;-1872;4095;3231
3042;0x55;180947;73;9796;205;-1863;8138;7349
3043;0x66;181753;76;4119;198;-1872;2445;2090
3044;0x77;181753;74;6095;207;-1872;4430;3443
3045;0x55;180947;73;9127;205;-1863;7469;6397
3046;0x66;176111;78;4079;219;-1813;2485;2123
3047;0x77;176111;75;5313;228;-1813;3728;3002
3048;0x55;180947;74;10425;207;-1863;8769;8256
3049;0x66;176111;78;4097;219;-1813;2503;2138
3050;0x77;176111;74;6283;207;-1813;4677;3604
3051;0x55;180947;72;9104;219;-1863;7460;6385
3052;0x66;181753;77;5259;209;-1872;3596;2918
3053;0x77;181753;75;5624;228;-1872;3980;3160
3054;0x55;180947;72;8469;219;-1863;6825;5561
3055;0x66;176111;81;5273;310;-1813;3770;3028
3056;0x77;176111;75;5834;228;-1813;4249;3328
3057;0x55;180947;76;11022;198;-1863;9357;9031
3058;0x66;176111;80;5908;280;-1813;4375;3408
3059;0x77;176111;76;5469;198;-1813;3854;3081
3060;0x55;180947;75;9501;228;-1863;7866;6956
3061;0x66;181753;78;4728;219;-1872;3075;2569
3062;0x77;181753;76;5395;198;-1872;3721;2997
3063;0x55;180947;75;8962;228;-1863;7327;6205
3064;0x66;181753;75;4297;228;-1872;2653;2257
3065;0x77;181753;76;5836;198;-1872;4162;3273
3066;0x55;180947;74;8466;207;-1863;6810;5543
3067;0x66;181753;74;5710;207;-1872;4045;3200
3068;0x77;181753;75;5588;228;-1872;3944;3137
3069;0x55;181753;74;10429;207;-1872;8764;8249
3070;0x66;181753;76;5812;198;-1872;4138;3258
3071;0x77;181753;74;5789;207;-1872;4124;3250
3072;0x55;181753;72;9302;219;-1872;7649;6648
3073;0x66;181753;75;3833;228;-1872;2189;1875
3074;0x77;176111;74;5999;207;-1813;4393;3419
3075;0x55;181753;75;9708;228;-1872;8064;7241
3076;0x66;176111;79;5271;230;-1813;3688;2976
3077;0x77;176111;76;5960;198;-1813;4345;3389
3078;0x55;180947;76;9586;198;-1863;7921;7035
3079;0x66;176111;78;4408;219;-1813;2814;2379
3080;0x77;176111;77;6240;209;-1813;4636;3577
3081;0x55;180947;77;10172;209;-1863;8518;7899
3082;0x66;176111;81;4879;310;-1813;3376;2774
3083;0x77;176111;76;5521;198;-1813;3906;3113
3084;0x55;180947;76;9656;198;-1863;7991;7136
3085;0x66;176111;78;5541;219;-1813;3947;3139
3086;0x77;176111;76;6114;198;-1813;4499;3487
3087;0x55;180947;76;10454;198;-1863;8789;8284
3088;0x66;176111;80;5142;280;-1813;3609;2926
3089;0x77;182559;77;6165;209;-1880;4494;3484
3090;0x55;180947;74;9061;207;-1863;7405;6310
3091;0x66;182559;79;4901;230;-1880;3251;2690
3092;0x77;182559;77;6240;209;-1880;4569;3533
3093;0x55;180947;75;9859;228;-1863;8224;7474
3094;0x66;182559;75;5410;228;-1880;3758;3021
3095;0x77;182559;78;6630;219;-1880;4969;3805
3096;0x55;180947;73;9512;205;-1863;7854;6939
3097;0x66;182559;78;3617;219;-1880;1956;1668
3098;0x77;182559;76;6359;198;-1880;4677;3604
3099;0x55;180947;74;8689;207;-1863;7033;5820
3100;0x66;181753;80;5255;280;-1872;3663;2960
3101;0x77;181753;76;5947;198;-1872;4273;3343
3102;0x55;180947;74;9118;207;-1863;7462;6388
3103;0x66;176917;79;4308;230;-1822;2716;2305
3104;0x77;176917;76;6181;198;-1822;4557;3525
3105;0x55;180947;75;10102;228;-1863;8467;7826
3106;0x66;176917;80;5264;280;-1822;3722;2998
3107;0x77;176917;76;6183;198;-1822;4559;3526
3108;0x55;180947;74;9501;207;-1863;7845;6926
3109;0x66;176917;73;6032;205;-1822;4415;3433
3110;0x77;176917;76;6066;198;-1822;4442;3450
3111;0x55;180947;75;9541;228;-1863;7906;7013
3112;0x66;176917;74;3562;207;-1822;1947;1660
3113;0x77;176111;76;6434;198;-1813;4819;3700
3114;0x55;180947;76;10427;198;-1863;8762;8246
3115;0x66;176111;78;4088;219;-1813;2494;2130
3116;0x77;176111;75;6325;228;-1813;4740;3646
3117;0x55;180947;74;10071;207;-1863;8415;7751
3118;0x66;182559;72;1843;219;-1880;182;159
3119;0x77;182559;75;5987;228;-1880;4335;3382
3120;0x55;180947;75;10256;228;-1863;8621;8047
3121;0x66;182559;76;4180;198;-1880;2498;2134
3122;0x55;180947;75;10069;228;-1863;8434;7778
3123;0x66;182559;74;3256;207;-1880;1583;1322
3124;0x77;182559;76;6533;198;-1880;4851;3722
3125;0x55;180947;74;9604;207;-1863;7948;7074
3126;0x66;182559;75;5458;228;-1880;3806;3051
3127;0x77;181753;76;6508;198;-1872;4834;3710
3128;0x55;180947;74;9501;207;-1863;7845;6926
3129;0x66;181753;77;4788;209;-1872;3125;2604
3130;0x77;181753;75;6397;228;-1872;4753;3655
3131;0x55;180947;74;9232;207;-1863;7576;6546
3132;0x66;176111;76;4270;198;-1813;2655;2258
3133;0x77;176111;73;6859;205;-1813;5251;4013
3134;0x55;180947;75;10431;228;-1863;8796;8294
3135;0x66;176111;78;2681;219;-1813;1087;853
3136;0x77;176111;73;6003;205;-1813;4395;3420
3137;0x55;180947;76;10335;198;-1863;8670;8117
3138;0x66;176111;77;3292;209;-1813;1688;1421
3139;0x77;176111;74;6445;207;-1813;4839;3714
3140;0x55;180947;74;10008;207;-1863;8352;7660
3141;0x66;176111;69;3091;221;-1813;1499;1243
3142;0x77;176111;75;6643;228;-1813;5058;3869
3143;0x55;180947;74;10607;207;-1863;8951;8507
3144;0x77;176111;76;6483;198;-1813;4868;3734
3145;0x55;180947;74;10170;207;-1863;8514;7894
3146;0x66;181753;75;3635;228;-1872;1991;1700
3147;0x77;181753;75;6857;228;-1872;5213;3984
3148;0x55;180947;74;9305;207;-1863;7649;6648
3149;0x66;181753;71;6467;230;-1872;4825;3704
3150;0x77;181753;75;7089;228;-1872;5445;4166
3151;0x55;180947;74;9142;207;-1863;7486;6421
3152;0x66;181753;76;3869;198;-1872;2195;1880
3153;0x77;181753;71;6246;230;-1872;4604;3556
3154;0x55;181753;75;10576;228;-1872;8932;8481
3155;0x66;181753;79;3860;230;-1872;2218;1900
3156;0x77;181753;72;5830;219;-1872;4177;3283
3157;0x55;181753;75;10211;228;-1872;8567;7970
3158;0x66;181753;79;3770;230;-1872;2128;1822
3159;0x77;176111;73;7281;205;-1813;5673;4359
3160;0x55;181753;74;10585;207;-1872;8920;8465
3161;0x66;176111;77;3835;209;-1813;2231;1911
3162;0x77;176111;73;5766;205;-1813;4158;3271
3163;0x55;181753;74;9879;207;-1872;8214;7459
3164;0x66;176111;80;4419;280;-1813;2886;2433
3165;0x77;176111;74;6334;207;-1813;4728;3638
3166;0x55;181753;75;10208;228;-1872;8564;7965
3167;0x66;176111;74;4608;207;-1813;3002;2517
3168;0x77;176111;73;6334;205;-1813;4726;3637
3169;0x55;181753;75;10037;228;-1872;8393;7719
3170;0x66;176111;78;4894;219;-1813;3300;2724
3171;0x77;176111;74;7315;207;-1813;5709;4390
3172;0x55;181753;74;10030;207;-1872;8365;7678
3173;0x66;176111;73;4685;205;-1813;3077;2570
3174;0x77;181753;74;6206;207;-1872;4541;3514
3175;0x55;181753;73;9327;205;-1872;7660;6663
3176;0x66;181753;79;4757;230;-1872;3115;2597
3177;0x77;181753;74;6010;207;-1872;4345;3389
3178;0x55;181753;74;8761;207;-1872;7096;5900
3179;0x66;181753;76;3619;198;-1872;1945;1658
3180;0x77;181753;75;7729;228;-1872;6085;4743
3181;0x55;180141;76;10483;198;-1855;8826;8336
3182;0x66;181753;72;1746;219;-1872;93;119
3183;0x77;181753;75;7087;228;-1872;5443;4165
3184;0x55;180141;73;9307;205;-1855;7657;6659
3185;0x66;180947;70;2837;223;-1863;1197;956
3186;0x77;180947;75;6621;228;-1863;4986;3817
3187;0x55;180141;75;9661;228;-1855;8034;7198
3188;0x66;176917;71;3576;230;-1822;1984;1694
3189;0x77;176917;74;7531;207;-1822;5916;4579
3190;0x55;180141;74;9480;207;-1855;7832;6907
3191;0x66;176917;74;4248;207;-1822;2633;2241
3192;0x77;176917;74;7581;207;-1822;5966;4627
3193;0x55;180947;74;9307;207;-1863;7651;6650
3194;0x66;176917;72;3885;219;-1822;2282;1955
3195;0x77;176917;72;7623;219;-1822;6020;4679
3196;0x55;180947;75;10242;228;-1863;8607;8027
3197;0x66;176917;69;1214;221;-1822;-387;65
3198;0x77;176111;74;7103;207;-1813;5497;4209
3199;0x55;180947;74;9931;207;-1863;8275;7548
3200;0x66;176111;64;4119;221;-1813;2527;2157
3201;0x77;176111;72;6772;219;-1813;5178;3958
3202;0x55;180947;76;10878;198;-1863;9213;8852
3203;0x66;178529;65;5868;216;-1838;4246;3326
3204;0x77;178529;72;6914;219;-1838;5295;4047
3205;0x55;180947;77;9906;209;-1863;8252;7514
3206;0x66;178529;74;4396;207;-1838;2765;2343
3207;0x77;178529;68;5685;226;-1838;4073;3218
3208;0x55;180947;75;10425;228;-1863;8790;8285
3209;0x66;178529;73;3238;205;-1838;1605;1343
3210;0x77;178529;73;7461;205;-1838;5828;4498
3211;0x55;180947;78;10630;219;-1863;8986;8555
3212;0x66;178529;74;2720;207;-1838;1089;855
3213;0x77;181753;72;6781;219;-1872;5128;3920
3214;0x55;180947;76;10127;198;-1863;8462;7819
3215;0x66;181753;77;3213;209;-1872;1550;1291
3216;0x77;181753;74;6708;207;-1872;5043;3858
3217;0x55;180947;75;10060;228;-1863;8425;7765
3218;0x66;176917;77;2641;209;-1822;1028;799
3219;0x77;176917;73;7229;205;-1822;5612;4306
3220;0x55;180947;73;9879;205;-1863;8221;7469
3221;0x66;176917;77;3258;209;-1822;1645;1381
3222;0x77;176917;74;6990;207;-1822;5375;4110
3223;0x55;180947;74;9782;207;-1863;8126;7331
3224;0x66;176917;76;1710;198;-1822;86;117
3225;0x77;176917;71;6896;230;-1822;5304;4054
3226;0x55;180947;73;9521;205;-1863;7863;6952
3227;0x66;176111;81;3249;310;-1813;1746;1475
3228;0x77;176111;74;7499;207;-1813;5893;4558
3229;0x55;180947;68;9891;226;-1863;8254;7517
3230;0x66;176111;84;2702;468;-1813;1357;1108
3231;0x77;176111;73;6598;205;-1813;4990;3820
3232;0x55;180947;73;11430;205;-1863;9772;9489
3233;0x66;180947;80;3170;280;-1863;1587;1326
3234;0x77;180947;74;7080;207;-1863;5424;4149
3235;0x55;180947;76;10380;198;-1863;8715;8180
3236;0x66;180947;77;2528;209;-1863;874;660
3237;0x77;180947;74;7504;207;-1863;5848;4516
3238;0x55;180947;76;10954;198;-1863;9289;8948
3239;0x66;180947;81;2708;310;-1863;1155;917
3240;0x77;180947;74;7506;207;-1863;5850;4518
3241;0x55;180947;75;10249;228;-1863;8614;8037
3242;0x66;180947;80;3240;280;-1863;1657;1392
3243;0x77;180947;74;7632;207;-1863;5976;4637
3244;0x55;180947;73;9142;205;-1863;7484;6418
3245;0x66;180947;82;2668;399;-1863;1204;963
3246;0x77;176917;75;8315;228;-1822;6721;5436
3247;0x55;180947;72;8385;219;-1863;6741;5460
3248;0x66;176917;89;2553;461;-1822;1192;951
3249;0x77;176917;73;7222;205;-1822;5605;4300
3250;0x55;180947;76;11114;198;-1863;9449;9141
3251;0x66;176917;77;2708;209;-1822;1095;861
3252;0x77;176917;74;7599;207;-1822;5984;4644
3253;0x55;180947;75;10731;228;-1863;9096;8701
3254;0x66;176917;85;3224;460;-1822;1862;1583
3255;0x77;176917;73;8340;205;-1822;6723;5438
3256;0x55;180947;75;10138;228;-1863;8503;7878
3257;0x66;176111;88;3256;484;-1813;1927;1642
3258;0x77;176111;74;8324;207;-1813;6718;5432
3259;0x55;180947;75;11414;228;-1863;9779;9496
3260;0x66;176111;90;3211;473;-1813;1871;1591
3261;0x77;182559;73;7497;205;-1880;5822;4492
3262;0x55;180947;76;10528;198;-1863;8863;8387
3263;0x66;182559;90;3292;473;-1880;1885;1604
3264;0x77;182559;73;7925;205;-1880;6250;4911
3265;0x55;180947;75;10783;228;-1863;9148;8769
3266;0x66;182559;88;3078;484;-1880;1682;1416
3267;0x77;182559;74;8342;207;-1880;6669;5375
3268;0x55;179335;74;10733;207;-1847;9093;8697
3269;0x66;182559;92;3173;475;-1880;1768;1496
3270;0x77;182559;72;7982;219;-1880;6321;4986
3271;0x55;179335;76;10828;198;-1847;9179;8809
3272;0x66;181753;80;3127;280;-1872;1535;1277
3273;0x77;181753;71;7743;230;-1872;6101;4759
3274;0x55;179335;76;11186;198;-1847;9537;9242
3275;0x66;176111;89;2652;461;-1813;1300;1053
3276;0x77;176111;71;7714;230;-1813;6131;4789
3277;0x55;179335;75;11159;228;-1847;9540;9245
3278;0x66;176111;86;2332;425;-1813;944;722
3279;0x77;176111;68;7853;226;-1813;6266;4928
3280;0x55;180947;74;11202;207;-1863;9546;9252
3281;0x66;176111;89;2875;461;-1813;1523;1265
3282;0x77;176111;68;6693;226;-1813;5106;3904
3283;0x55;180947;70;9368;223;-1863;7728;6759
3284;0x66;176111;81;2859;310;-1813;1356;1107
3285;0x77;177723;68;7272;226;-1830;5668;4354
3286;0x55;180947;74;11024;207;-1863;9368;9045
3287;0x66;177723;89;3107;461;-1830;1738;1468
3288;0x77;177723;68;7916;226;-1830;6312;4976
3289;0x55;180947;74;10794;207;-1863;9138;8756
3290;0x66;181753;84;3452;468;-1872;2048;1751
3291;0x77;181753;66;7056;223;-1872;5407;4136
3292;0x55;180947;74;10918;207;-1863;9262;8914
3293;0x66;181753;88;2614;484;-1872;1226;983
3294;0x77;181753;69;8347;221;-1872;6696;5406
3295;0x55;180947;71;8955;230;-1863;7322;6198
3296;0x66;181753;84;2749;468;-1872;1345;1096
3297;0x77;181753;64;7684;221;-1872;6033;4692
3298;0x55;181753;73;10627;205;-1872;8960;8520
3299;0x66;181753;86;3125;425;-1872;1678;1412
3300;0x77;183365;65;7452;216;-1888;5780;4454
3301;0x55;181753;73;10993;205;-1872;9326;8994
3302;0x66;183365;81;2629;310;-1888;1051;820
3303;0x77;183365;66;7184;223;-1888;5519;4227
3304;0x55;181753;70;10235;223;-1872;8586;7997
3305;0x66;176917;88;2846;484;-1822;1508;1251
3306;0x77;176917;69;7529;221;-1822;5928;4591
3307;0x55;180141;75;11148;228;-1855;9521;9223
3308;0x66;176917;87;2086;431;-1822;695;507
3309;0x77;176917;70;6882;223;-1822;5283;4038
3310;0x55;180141;74;10476;207;-1855;8828;8338
3311;0x66;176917;90;2735;473;-1822;1386;1135
3312;0x77;176917;71;8079;230;-1822;6487;5167
3313;0x55;180141;75;10465;228;-1855;8838;8352
3314;0x66;176917;86;2438;425;-1822;1041;811
3315;0x77;176917;70;7617;223;-1822;6018;4677
3316;0x66;176917;81;3231;310;-1822;1719;1450
3317;0x77;176917;69;7741;221;-1822;6140;4798
3318;0x55;180141;74;10677;207;-1855;9029;8612
3319;0x66;181753;81;3019;310;-1872;1457;1203
3320;0x77;181753;71;8707;230;-1872;7065;5860
3321;0x55;180141;72;10188;219;-1855;8552;7948
3322;0x66;181753;83;3222;388;-1872;1738;1468
3323;0x77;181753;70;7720;223;-1872;6071;4729
3324;0x55;180141;75;11078;228;-1855;9451;9143
3325;0x66;181753;81;2348;310;-1872;786;583
3326;0x77;181753;71;8182;230;-1872;6540;5226
3327;0x55;180947;72;10335;219;-1863;8691;8146
3328;0x66;180947;81;2807;310;-1863;1254;1010
3329;0x77;180947;70;7472;223;-1863;5832;4501
3330;0x55;180947;72;10037;219;-1863;8393;7719
3331;0x66;180947;80;2803;280;-1863;1220;978
3332;0x77;175305;70;8054;223;-1805;6472;5150
3333;0x55;180947;73;9999;205;-1863;8341;7644
3334;0x66;175305;78;2197;219;-1805;611;439
3335;0x77;175305;68;7358;226;-1805;5779;4453
3336;0x55;180141;74;10506;207;-1855;8858;8380
3337;0x66;175305;65;-252;216;-1805;-1840;3208
3338;0x77;175305;71;7887;230;-1805;6312;4976
3339;0x55;180141;73;10362;205;-1855;8712;8176
3340;0x66;175305;69;7508;221;-1805;5924;4587
3341;0x77;175305;71;8500;230;-1805;6925;5684
3342;0x55;180141;74;10666;207;-1855;9018;8598
3343;0x66;176917;78;3193;219;-1822;1590;1329
3344;0x77;176917;70;8182;223;-1822;6583;5275
3345;0x55;180141;72;10366;219;-1855;8730;8201
3346;0x66;176917;77;3053;209;-1822;1440;1187
3347;0x77;182559;70;7941;223;-1880;6284;4947
3348;0x55;180141;74;9708;207;-1855;8060;7236
3349;0x66;182559;81;2217;310;-1880;647;468
3350;0x77;182559;71;7565;230;-1880;5915;4579
3351;0x55;180141;69;9208;221;-1855;7574;6543
3352;0x66;182559;86;1931;425;-1880;476;338
3353;0x77;182559;71;8354;230;-1880;6704;5416
3354;0x55;178529;73;11069;205;-1838;9436;9126
3355;0x66;182559;90;2093;473;-1880;686;500
3356;0x77;182559;71;7441;230;-1880;5791;4464
3357;0x55;178529;74;11831;207;-1838;10200;10200
3358;0x66;181753;81;2158;310;-1872;596;428
3359;0x77;181753;71;7961;230;-1872;6319;4984
3360;0x55;178529;70;9543;223;-1838;7928;7045
3361;0x66;176111;90;2314;473;-1813;974;749
3362;0x77;176111;70;7750;223;-1813;6160;4818
3363;0x55;178529;75;10661;228;-1838;9051;8642
3364;0x66;176111;91;1899;482;-1813;568;406
3365;0x77;176111;70;7898;223;-1813;6308;4972
3366;0x55;180947;75;12122;228;-1863;10487;10487
3367;0x66;176111;80;2325;280;-1813;792;588
3368;0x77;176111;70;7862;223;-1813;6272;4934
3369;0x55;180947;76;11089;198;-1863;9424;9111
3370;0x66;176111;80;2925;280;-1813;1392;1141
3371;0x77;176111;70;8651;223;-1813;7061;5855
3372;0x55;180947;73;10330;205;-1863;8672;8119
3373;0x66;176111;80;2857;280;-1813;1324;1076
3374;0x77;176111;71;7964;230;-1813;6381;5050
3375;0x55;180947;74;11619;207;-1863;9963;9664
3376;0x66;181753;81;2312;310;-1872;750;553
3377;0x77;181753;71;8315;230;-1872;6673;5379
3378;0x55;180947;74;11204;207;-1863;9548;9254
3379;0x66;181753;77;1147;209;-1872;-516;110
3380;0x77;176111;70;9066;223;-1813;7476;6407
3381;0x55;180947;74;9994;207;-1863;8338;7639
3382;0x66;176111;90;2163;473;-1813;823;615
3383;0x77;176111;70;8322;223;-1813;6732;5449
3384;0x55;180141;72;10454;219;-1855;8818;8324
3385;0x66;176111;81;2071;310;-1813;568;406
3386;0x77;180947;71;8480;230;-1863;6847;5588
3387;0x55;180141;76;10206;198;-1855;8549;7944
3388;0x66;180947;81;2438;310;-1863;885;669
3389;0x77;180947;70;8394;223;-1863;6754;5475
3390;0x55;180141;74;11175;207;-1855;9527;9230
3391;0x66;176917;93;2089;500;-1822;767;567
3392;0x77;176917;70;8750;223;-1822;7151;5972
3393;0x55;180947;77;11993;209;-1863;10339;10339
3394;0x66;176917;93;1917;500;-1822;595;427
3395;0x77;176917;70;8899;223;-1822;7300;6168
3396;0x55;180947;75;11455;228;-1863;9820;9536
3397;0x66;176917;81;2057;310;-1822;545;389
3398;0x77;176917;70;8363;223;-1822;6764;5487
3399;0x55;180947;76;11461;198;-1863;9796;9513
3400;0x66;176917;81;1893;310;-1822;381;274
3401;0x77;176917;71;9280;230;-1822;7688;6703
3402;0x66;176917;80;2325;280;-1822;783;581
3403;0x77;176917;71;8757;230;-1822;7165;5990
3404;0x55;180947;75;11148;228;-1863;9513;9214
3405;0x77;181753;69;7961;221;-1872;6310;4974
3406;0x55;180947;75;11195;228;-1863;9560;9267
3407;0x66;181753;80;2021;280;-1872;429;306
3408;0x77;181753;70;9417;223;-1872;7768;6816
3409;0x55;180947;73;10395;205;-1863;8737;8211
3410;0x66;181753;90;1451;473;-1872;52;104
3411;0x77;181753;70;8804;223;-1872;7155;5977
3412;0x55;180141;74;12354;207;-1855;10706;10706
3413;0x66;181753;81;2032;310;-1872;470;334
3414;0x77;181753;68;7732;226;-1872;6086;4744
3415;0x55;180141;72;9451;219;-1855;7815;6883
3416;0x66;181753;87;1935;431;-1872;494;351
3417;0x77;175305;69;8831;221;-1805;7247;6098
3418;0x55;180141;72;9803;219;-1855;8167;7391
3419;0x66;175305;93;1742;500;-1805;437;311
3420;0x77;175305;70;9388;223;-1805;7806;6870
3421;0x55;181753;72;10853;219;-1872;9200;8836
3422;0x66;175305;91;1710;482;-1805;387;278
3423;0x77;175305;70;9133;223;-1805;7551;6511
3424;0x55;181753;73;11222;205;-1872;9555;9262
3425;0x66;175305;81;1856;310;-1805;361;261
3426;0x77;175305;70;8978;223;-1805;7396;6298
3427;0x55;181753;74;10943;207;-1872;9278;8934
3428;0x66;176917;92;2016;475;-1822;669;486
3429;0x77;176917;69;8414;221;-1822;6813;5546
3430;0x55;181753;72;11085;219;-1872;9432;9121
3431;0x66;176917;81;1444;310;-1822;-68;68
3432;0x77;180947;68;8020;226;-1863;6383;5052
3433;0x55;181753;73;10544;205;-1872;8877;8406
3434;0x66;180947;81;1701;310;-1863;148;143
3435;0x77;180947;69;9354;221;-1863;7712;6736
3436;0x55;181753;73;11013;205;-1872;9346;9018
3437;0x66;180947;90;1687;473;-1863;297;222
3438;0x77;180947;69;9244;221;-1863;7602;6582
3439;0x55;180947;72;10968;219;-1863;9324;8991
3440;0x66;180947;97;1171;660;-1863;-32;77
3441;0x77;180947;70;9460;223;-1863;7820;6890
3442;0x55;180947;74;10997;207;-1863;9341;9012
3443;0x66;181753;93;1440;500;-1872;68;110
3444;0x77;181753;69;8847;221;-1872;7196;6030
3445;0x55;180947;76;12070;198;-1863;10405;10405
3446;0x66;176111;98;1372;720;-1813;279;211
3447;0x77;176111;69;9271;221;-1813;7679;6690
3448;0x55;180947;72;11333;219;-1863;9689;9406
3449;0x66;176111;91;1223;482;-1813;-108;60
3450;0x77;176111;69;9235;221;-1813;7643;6639
3451;0x55;180141;73;11153;205;-1855;9503;9203
3452;0x66;181753;99;1239;743;-1872;110;127
3453;0x77;181753;68;9221;226;-1872;7575;6544
3454;0x55;180141;75;11610;228;-1855;9983;9681
3455;0x66;181753;99;1144;743;-1872;15;91
3456;0x77;175305;69;9266;221;-1805;7682;6694
3457;0x55;180141;74;11225;207;-1855;9577;9286
3458;0x66;175305;98;851;720;-1805;-234;48
3459;0x77;175305;69;9050;221;-1805;7466;6393
3460;0x55;180141;76;12291;198;-1855;10634;10634
3461;0x66;181753;100;1239;761;-1872;128;134
3462;0x77;181753;68;9415;226;-1872;7769;6817
3463;0x55;180141;76;11344;198;-1855;9687;9403
3464;0x66;181753;103;903;763;-1872;-206;49
3465;0x77;181753;67;8888;223;-1872;7239;6087
3466;0x55;180141;75;11908;228;-1855;10281;10281
3467;0x66;181753;108;1038;759;-1872;-75;66
3468;0x77;181753;64;8685;221;-1872;7034;5821
3469;0x55;180141;77;11795;209;-1855;10149;10149
3470;0x66;181753;112;964;745;-1872;-163;52
3471;0x77;180947;65;9827;216;-1863;8180;7410
3472;0x55;180141;72;11371;219;-1855;9735;9452
3473;0x66;180947;116;1174;841;-1863;152;145
3474;0x77;180947;68;9176;226;-1863;7539;6494
3475;0x55;180141;73;11601;205;-1855;9951;9654
3476;0x66;176111;115;872;827;-1813;-114;59
3477;0x77;176111;67;9273;223;-1813;7683;6696
3478;0x55;180141;75;12009;228;-1855;10382;10382
3479;0x66;176111;117;797;843;-1813;-173;51
3480;0x77;176111;67;8789;223;-1813;7199;6034
3481;0x55;180141;71;11908;230;-1855;10283;10283
3482;0x66;181753;112;1304;745;-1872;177;157
3483;0x77;181753;66;9314;223;-1872;7665;6670
3484;0x55;180141;72;11558;219;-1855;9922;9629
3485;0x66;176111;104;698;768;-1813;-347;57
3486;0x77;176111;65;8629;216;-1813;7032;5818
3487;0x55;180141;76;11840;198;-1855;10183;10183
3488;0x66;176111;103;757;763;-1813;-293;50
3489;0x77;176111;61;8820;230;-1813;7237;6084
3490;0x55;180141;73;11743;205;-1855;10093;10093
3491;0x66;180947;105;1047;728;-1863;-88;64
3492;0x77;180947;63;10211;215;-1863;8563;7964
3493;0x55;180141;76;11723;198;-1855;10066;10066
3494;0x66;180947;103;923;763;-1863;-177;51
3495;0x77;180947;64;10350;221;-1863;8708;8170
3496;0x55;180141;74;11355;207;-1855;9707;9424
3497;0x66;180947;106;714;743;-1863;-406;70
3498;0x77;180947;63;9485;215;-1863;7837;6914
3499;0x55;180947;76;11585;198;-1863;9920;9627
3500;0x66;181753;105;937;728;-1872;-207;49
3501;0x77;181753;63;9025;215;-1872;7368;6260
3502;0x55;180947;74;11216;207;-1863;9560;9267
3503;0x66;181753;107;989;754;-1872;-129;56
3504;0x77;176111;62;8617;205;-1813;7009;5789
3505;0x55;180947;76;11236;198;-1863;9571;9279
3506;0x66;176111;104;1011;768;-1813;-34;76
3507;0x77;176111;61;8615;230;-1813;7032;5818
3508;0x55;180141;75;11799;228;-1855;10172;10172
3509;0x66;176111;103;754;763;-1813;-296;50
3510;0x77;180947;58;6627;216;-1863;4980;3813
3511;0x55;180141;75;11464;228;-1855;9837;9552
3512;0x66;180947;103;1207;763;-1863;107;125
3513;0x77;180947;59;8658;223;-1863;7018;5801
3514;0x55;180141;74;11391;207;-1855;9743;9461
3515;0x66;176111;101;1005;791;-1813;-17;81
3516;0x77;176111;59;10968;223;-1813;9378;9057
3517;0x55;180947;74;11905;207;-1863;10249;10249
3518;0x66;176111;98;1016;720;-1813;-77;66
3519;0x77;182559;60;12092;214;-1880;10426;10426
3520;0x55;180947;75;11470;228;-1863;9835;9550
3521;0x66;182559;81;1455;310;-1880;-115;59
3522;0x77;182559;59;11342;223;-1880;9685;9401
3523;0x55;180947;75;11400;228;-1863;9765;9482
3524;0x66;175305;98;887;720;-1805;-198;49
3525;0x77;175305;54;9724;214;-1805;8133;7342
3526;0x55;180947;75;11775;228;-1863;10140;10140
3527;0x66;175305;105;872;728;-1805;-205;49
3528;0x55;180947;75;10981;228;-1863;9346;9018
3529;0x66;180947;107;1140;754;-1863;31;96
3530;0x77;180947;51;3855;254;-1863;2246;1924
3531;0x55;180947;76;11398;198;-1863;9733;9450
3532;0x66;174499;106;951;743;-1797;-103;61
3533;0x77;174499;56;7222;232;-1797;5657;4345
3534;0x55;180947;76;11626;198;-1863;9961;9663
3535;0x66;174499;103;851;763;-1797;-183;50
3536;0x77;174499;58;9870;216;-1797;8289;7568
3537;0x55;180141;76;11986;198;-1855;10329;10329
3538;0x66;180947;103;1176;763;-1863;76;113
3539;0x77;180947;57;10853;223;-1863;9213;8852
3540;0x55;180141;76;11795;198;-1855;10138;10138
3541;0x66;180947;101;1038;791;-1863;-34;76
3542;0x77;175305;58;11051;216;-1805;9462;9156
3543;0x55;180141;76;11928;198;-1855;10271;10271
3544;0x66;175305;103;932;763;-1805;-110;60
3545;0x77;175305;57;10715;223;-1805;9133;8750
3546;0x55;180141;76;12119;198;-1855;10462;10462
3547;0x66;175305;102;1316;782;-1805;293;219
3548;0x77;175305;57;11252;223;-1805;9670;9386
3549;0x55;180141;76;11849;198;-1855;10192;10192
3550;0x66;175305;101;951;791;-1805;-63;69
3551;0x77;175305;56;11360;232;-1805;9787;9504
3552;0x55;180141;76;11860;198;-1855;10203;10203
3553;0x66;174499;101;919;791;-1797;-87;64
3554;0x77;174499;57;10673;223;-1797;9099;8705
3555;0x55;180141;76;12072;198;-1855;10415;10415
3556;0x66;174499;107;759;754;-1797;-284;50
3557;0x77;181753;56;10301;232;-1872;8661;8104
3558;0x55;180141;76;11292;198;-1855;9635;9349
3559;0x66;181753;106;1047;743;-1872;-82;65
3560;0x77;181753;56;10636;232;-1872;8996;8568
3561;0x55;180141;76;11094;198;-1855;9437;9127
3562;0x66;176917;104;962;768;-1822;-92;63
3563;0x77;176917;58;11369;216;-1822;9763;9480
3564;0x55;180141;75;11464;228;-1855;9837;9552
3565;0x66;176917;106;781;743;-1822;-298;51
3566;0x77;176917;59;10366;223;-1822;8767;8253
3567;0x55;180141;76;11168;198;-1855;9511;9212
3568;0x66;181753;107;1122;754;-1872;4;87
3569;0x77;181753;57;10098;223;-1872;8449;7800
3570;0x55;180141;76;11423;198;-1855;9766;9483
3571;0x66;176111;110;820;809;-1813;-184;50
3572;0x77;176111;57;11060;223;-1813;9470;9165
3573;0x55;180141;77;11858;209;-1855;10212;10212
3574;0x66;176111;108;883;759;-1813;-171;51
3575;0x77;176111;58;10310;216;-1813;8713;8177
3576;0x55;180947;76;12025;198;-1863;10360;10360
3577;0x66;176111;104;1160;768;-1813;115;129
3578;0x77;176111;54;10283;214;-1813;8684;8136
3579;0x55;180947;76;11569;198;-1863;9904;9613
3580;0x66;176111;108;912;759;-1813;-142;55
3581;0x77;176917;54;9404;214;-1822;7796;6856
3582;0x55;180947;74;11705;207;-1863;10049;10049
3583;0x66;176917;108;741;759;-1822;-322;53
3584;0x77;176917;57;10035;223;-1822;8436;7781
3585;0x55;180947;75;12439;228;-1863;10804;10804
3586;0x66;181753;107;996;754;-1872;-122;58
3587;0x77;181753;58;8944;216;-1872;7288;6152
3588;0x55;180947;75;11896;228;-1863;10261;10261
3589;0x66;181753;108;791;759;-1872;-322;53
3590;0x77;176917;61;9927;230;-1822;8335;7635
3591;0x55;180947;74;11804;207;-1863;10148;10148
3592;0x66;176917;107;802;754;-1822;-266;49
3593;0x77;176917;60;10380;214;-1822;8772;8260
3594;0x55;180141;75;11889;228;-1855;10262;10262
3595;0x66;176917;108;811;759;-1822;-252;48
3596;0x77;180947;62;10247;205;-1863;8589;8001
3597;0x55;180141;75;11725;228;-1855;10098;10098
3598;0x66;180947;107;989;754;-1863;-120;58
3599;0x77;180947;60;10283;214;-1863;8634;8065
3600;0x55;180141;76;11802;198;-1855;10145;10145
3601;0x66;175305;108;736;759;-1805;-310;52
3602;0x77;175305;61;10715;230;-1805;9140;8759
3603;0x55;179335;75;12083;228;-1847;10464;10464
3604;0x66;175305;108;921;759;-1805;-125;57
3605;0x77;175305;61;10542;230;-1805;8967;8529
3606;0x55;179335;75;11662;228;-1847;10043;10043
3607;0x66;175305;109;1045;743;-1805;-17;81
3608;0x77;175305;62;10350;205;-1805;8750;8229
3609;0x55;179335;75;11851;228;-1847;10232;10232
3610;0x66;175305;109;845;743;-1805;-217;48
3611;0x77;175305;61;10760;230;-1805;9185;8817
3612;0x55;179335;75;11889;228;-1847;10270;10270
3613;0x66;175305;109;811;743;-1805;-251;48
3614;0x77;175305;60;10132;214;-1805;8541;7932
3615;0x55;179335;76;12031;198;-1847;10382;10382
3616;0x66;181753;109;1126;743;-1872;-3;85
3617;0x77;181753;60;10188;214;-1872;8530;7917
3618;0x55;179335;75;11757;228;-1847;10138;10138
3619;0x66;181753;109;836;743;-1872;-293;50
